my_map = [
  [1,1,1,1,1,1,1,1,1,1,1,1,1,1,1],
  [1,1,1,1,1,1,1,1,1,1,1,1,1,1,1],
  [1,1,1,1,1,1,1,1,1,1,1,1,1,1,1],
  [1,1,1,1,1,1,1,1,1,1,1,1,1,1,1],
  [1,1,1,1,1,1,1,1,1,1,1,1,1,1,1],
  [2,2,1,1,1,1,1,1,1,1,1,2,1,1,1],
  [2,2,1,1,2,2,1,1,1,1,2,2,2,1,1],
  [2,2,2,2,2,2,2,2,2,2,2,2,2,2,2],
  [2,2,2,2,2,2,2,2,2,2,2,2,2,2,2],
  [3,3,3,3,3,3,3,3,3,3,3,3,3,3,3]
];

my_rotations = [
  [0,0,0,0,0,0,0,0,0,0,0,0,0,0,0],
  [0,0,0,0,0,0,0,0,0,0,0,0,0,0,0],
  [0,0,0,0,0,0,0,0,0,0,0,0,0,0,0],
  [0,0,0,0,0,0,0,0,0,0,0,0,0,0,0],
  [0,0,0,0,0,0,0,0,0,0,0,0,0,0,0],
  [0,0,0,0,0,0,0,0,0,0,0,0,0,0,0],
  [0,0,0,0,0,0,0,0,0,0,0,0,0,0,0],
  [0,0,0,0,0,0,0,0,0,0,0,0,0,0,0],
  [0,0,0,0,0,0,0,0,0,0,0,0,0,0,0],
  [0,0,0,0,0,0,0,0,0,0,0,0,0,0,0]
];

my_items = [
  [4,0,0,0,0,0,0,0,0,0,0,0,0,0,4],
  [0,0,0,0,0,0,0,0,0,0,0,0,0,0,0],
  [0,0,5,0,6,0,0,0,0,0,0,6,5,0,0],
  [0,0,6,6,6,0,0,5,0,0,0,6,6,0,0],
  [0,0,0,0,0,0,0,6,6,0,0,0,0,0,0],
  [0,0,0,0,0,0,0,0,0,0,0,0,0,0,4],
  [0,0,4,0,0,0,4,0,0,0,0,0,0,4,4],
  [0,0,0,0,0,0,0,0,0,0,0,0,0,0,0],
  [0,0,0,0,0,0,0,0,0,0,0,0,0,0,0],
  [0,0,0,0,0,0,0,0,0,0,0,0,0,0,0]
];

# ID Mapping (Numeric ID: Original ID)
# 1: fondo4
# 2: terreno10
# 3: terreno8
# 4: terreno6
# 5: objeto13
# 6: terreno12
# End ID Mapping
