my_map = [
  [1,1,1,1,1,1,1,1,1,1,1,1,1,1,1],
  [1,1,1,1,1,1,1,1,1,1,1,1,1,1,1],
  [2,2,2,2,2,2,2,1,1,1,1,2,2,2,2],
  [1,1,1,1,1,1,1,1,1,1,1,1,1,1,1],
  [1,1,1,1,1,1,1,1,1,1,1,1,1,1,1],
  [1,1,1,1,2,1,1,1,1,1,2,1,1,1,1],
  [1,1,2,2,2,2,2,2,2,2,2,2,2,2,1],
  [2,2,2,2,2,2,2,2,2,2,2,2,2,2,2],
  [3,3,3,3,3,3,3,3,3,3,3,3,3,3,3],
  [3,3,3,3,3,3,3,3,3,3,3,3,3,3,3]
];

my_rotations = [
  [0,0,0,0,0,0,0,0,0,0,0,0,0,0,0],
  [0,0,0,0,0,0,0,0,0,0,0,0,0,0,0],
  [0,0,0,0,0,0,0,0,0,0,0,0,0,0,0],
  [0,0,0,0,0,0,0,0,0,0,0,0,0,0,0],
  [0,0,0,0,0,0,0,0,0,0,0,0,0,0,0],
  [0,0,0,0,0,0,0,0,0,0,0,0,0,0,0],
  [0,0,0,0,0,0,0,0,0,0,0,0,0,0,0],
  [0,0,0,0,0,0,0,0,0,0,0,0,0,0,0],
  [0,0,0,0,0,0,0,0,0,0,0,0,0,0,0],
  [0,0,0,0,0,0,0,0,0,0,0,0,0,0,0]
];

my_items = [
  [0,0,0,0,0,0,0,0,0,0,0,0,0,0,0],
  [0,0,0,0,4,0,0,0,5,5,0,6,0,0,0],
  [0,0,0,0,0,0,0,0,5,0,0,0,0,0,0],
  [0,0,0,0,0,0,0,0,5,0,0,0,0,0,0],
  [0,0,0,0,0,0,0,5,5,0,0,0,0,0,0],
  [0,0,0,0,0,0,0,0,0,0,0,7,0,0,0],
  [0,8,0,0,0,0,0,0,0,0,0,0,0,0,0],
  [0,0,0,0,0,0,0,0,0,0,0,0,0,0,0],
  [0,0,0,0,0,0,0,0,0,0,0,0,0,0,0],
  [0,0,0,0,0,0,0,0,0,0,0,0,0,0,0]
];

# ID Mapping (Numeric ID: Original ID)
# 1: fondo3 (fondos/tile2.png)
# 2: terreno47 (terrenos/tile46.png)
# 3: terreno2 (terrenos/tile1.png)
# 4: enemigo1 (enemigos/tile0.png)
# 5: item0 (items/tile0.png)
# 6: enemigo3 (enemigos/tile2.png)
# 7: enemigo2 (enemigos/tile1.png)
# 8: enemigo4 (enemigos/tile3.png)
# End ID Mapping

# Matrix Size: 10x15
# Tile Size: 32px
